NO ./textures/north.xpm
WE ./textures/west.xpm
SO ./textures/south.xpm
EA ./textures/east.xpm

F 116,212,52
C 135,206,235



11111111111111111111111111111111111111111111111111111111
1000000000000000000000000000000000000000000000000000001
10000W00000000000000000000111110000000000000000000000001
100000000000000000000000001    1000000000000000000000001
10000000000000000000000000011110000000000000000000000001
10000000000000000000000000000000000000000000000000000001
11111111111111111111111111111011111111111111111111111111
        1111111111111111111110111
                          1110011
                          1100101
                          1100001
                          1100001
                           11101111111
                             100000001
                            1111111101
                                   101
                                   101
                                111101111111111111111111111111111111111111111111
                                100000000000111100000000000000000000010000001101
                                100000000000111000000000000000000000010000001101
                                1000000000001  100000000000000000000000000001101
                                1000000000001  100000000000000000000000000001101
                                1000000000001  100000000000000000000000000001101
                                100000000000111100000000000000000000000000001101
                                100000000000000000000000000000000000000000001101
                                100000000000111100000000000000000000000000001101
                                1000000000001  100000000000000000000000000001101
                                1000000000001  100000000000000000000000000001101
                                100000000000111000000000000000000000010000000001
                                111111111111111111111111111111111111111111111111
