

NO ./textures/blue.xpm
WE ./textures/green.xpm
EA ./textures/yellow.xpm
F 116,212,52
SO ./textures/red.xpm
C 135,206,235

 1111111111111111111111
100000000000000000000001
 1000000000000000000001
  10000000000000 00001			11111111111
   100000000000000001			10100000101
    1000000S00000001			100    1001
     10000000000001				10100000101
      10000 000001				11111111111
       100   0001
        10000001
         100001
          1001
           11