NO ./textures/blue.xpm
WE ./textures/green.xpm
SO ./textures/red.xpm
EA ./textures/yellow.xpm

F 116,212,52
C 135,206,235


11111111111111111111111111111
100001  101101000000000000001
1000N1  100100000001010000001
11111111111111111111111111111
11111111111111111111111111111
