NO ./textures/a.xpm
WE ./textures/b.xpm
SO ./textures/south.xpm
EA ./textures/east.xpm

F 84,2,51
C 135,206,235

1111111111111111111111111111111111111111111111111111111111111111
1000000000000000000000000000000000000000000000000000000000000001
1111111111111111111111111111111111111111111111111111111111111001
1111111111111111111111111111111111111111111111111111111111111001
1000000000000000000000000000000000000000000000000000000000000001
1001111111111111111111111111111111111111111111111111111111111111
1001111111111111111111111111111111111111111111111111111111111111
1000000000000000000000000000000000000000000000000000000000000001
1111111111111111111111111111111111111111111111111111111111111001
1111111111111111111111111111111111111111111111111111111111111001
1000000000000000000000000000000000000000000000000000000000000001
1001111111111111111111111111111111111111111111111111111111111111
1001111111111111111111111111111111111111111111111111111111111111
1000000000000000000000000000000000000000000000000000000000000001
1111111111111111111111101111111111111111111111111111111111111001
1111111111111111111111101111111111111111111111111111111111111001
1000000000000000000000000000000000000000000000000000000000000001
1N00000000000000000000000000000000000000000000000000000000000001
1111111111111111111111111111111111111111111111111111111111111111
