NO ./textures/blue.xpm
WE ./textures/green.xpm
SO ./textures/red.xpm
EA ./textures/yellow.xpm

F 116,212,52
C 135,206,235





 111
1N01
1111
