EA ./textures/using/ventana.xpm
NO ./textures/using/enredadera.xpm
WE ./textures/using/brickrosa.xpm
SO ./textures/using/brickamarillo.xpm

F 214,194,133
C 152,245,239
1111111111111111111111111111
100000000000000000000001
1111111111111111111111111111
