			SO   		./textures/red.xpm		   



 WE  	 ./textures/green.xpm
 

	  EA ./textures/yellow.xpm

   						 	NO        	 ./textures/blue.xpm   	  	
    F	 191, 54, 12
 C	  0, 172, 193 





11111111111
101001 1101
100N0111001
10100011101
1111111 111