			SO   		./textures/red.xpm		   



 WE  	 ./textures/green.xpm
 

	  EA ./textures/yellow.xpm

   						 	NO        	 ./textures/blue.xpm   	  	
    F	 15, 25, 35
 C	  10, 20, 30 





11111111111
101001 1101
100N0111001
10100011101
1111111 111