
F 116,212,100
C 135,206,255

SO ./textures/red.xpm
EA ./textures/yellow.xpm
WE ./textures/green.xpm
NO ./textures/blue.xpm

11111111111
10100000101
1000S001001
1010000 101
11111111111
