

			SO ./textures/red.xpm		
	  EA ./textures/yellow.xpm
 WE ./textures/green.xpm
NO ./textures/blue.xpm   	  		

 

F 116,212,100   
	
C	  135,206,255

11111111111
10100000101
1000E001001
10100001101
11111111111
