 WE  	 ./textures/green.xpm
 


    F	 116    	,  212, 100


 C	  255, 206,		200  
			SO   		./textures/red.xpm		   


	  EA ./textures/yellow.xpm
	 	NO        	 ./textures/blue.xpm   	  				 
11111111111
101000 0101
1000E001001
10100011101
1111111 111