			SO   		./textures/red.xpm		   



 WE  	 ./textures/green.xpm
 

	  EA ./textures/yellow.xpm

   						 	NO        	 ./textures/blue.xpm   	  	
    F	 51, 153, 255
 C	  0, 51, 204 





11111111111
101001 1101
1000E111001
10100011101
1111111 111