			SO   		./textures/red.xpm		   



 WE  	 ./textures/green.xpm
 

	  EA ./textures/yellow.xpm

   						 	NO        	 ./textures/blue.xpm   	  	
    F	 116    ,  21, 100
 C	  255    , 206,		200  




11111111111
101000 0101
1000S001001
10100011101
1111111 111

