			SO   		./textures/red.xpm		   



 WE  	 ./textures/green.xpm
 

	  EA ./textures/yellow.xpm

   						 	NO        	 ./textures/blue.xpm   	  	
    F	 116    ,  21, 100
 C	  255    , 206,		200  

11111111111111111111111111111
11111111110000000000000000011111
        10110000011100000000000111111
        100000000110000011111111111
11111111111111011100000010001
11111111000001111100000010001
       1000001 100000001100011111111
    11110000111101000W00000011111
11111111111111111111111111111

11111111111111111111111111111
10000000111100010000000001001
100000001  100110101110000001
10000000111110000001 10100001
11111111111111111111 11111111