NO ./textures/blue.xpm
WE ./textures/green.xpm
SO ./textures/red.xpm
EA ./textures/yellow.xpm

F 116,212,52
C 135,206,235


111111111111111111111
100000000000000000001
100000000000000000001
100000000000000000001
100000000000000000001
100000000000000000001
100000000S00000000001
100000000000000000001
100000000000000000001
100000000000000000001
111111111111111111111