NO ./textures/blue.xpm
  	C 135,  206,235 	

WE ./textures/green.xpm
SO ./textures/red.xpm
EA ./textures/yellow.xpm

F    116, 	212,	52

 1111111111111111111111
100000000000S00000000001
 1000000000000000000001
  10000000000000000001
   100000000000000001
    1001000000000001
     10000001100001
      100001  1001
       1000011001
        10000001
         101101
          1001
           11
