NO ./textures/blue.xpm
WE ./textures/green.xpm
SO ./textures/red.xpm
EA ./textures/yellow.xpm

F 116,212,52
C 135,206,235

 1111111111111111111111
100000000000S00000000001
 1000000000000000000001
  10000000000000000001
   100000111111000001
    100001    100001
     10001111110001
      100000000001
       1000000001
        10000001
         101101
          1001
           11