 NO ./textures/blue.xpm	
     F 194,178,123                	
		WE ./textures/green.xpm


EA ./textures/yellow.xpm   	  

 
            SO ./textures/red.xpm	

	 C 42,173,230

        1111111111111111111111111  
        1000000000110000000000001	
        1011000001110000000000001	
        1011000000000000000000001
111111111011000001110000000000001 
100000000011000001110111110111111
11110111111111011100000010001
11110111111111011101010010001
1100000011010101 100001010001
10000000000000001100000000001
10000000000000E01101010010001
11000001110101011111011110001	 
11110111 1110101 101111010001 
11111111 1111111 111111111111
