NO ./textures/blue.xpm
WE ./textures/green.xpm
SO ./textures/red.xpm
EA ./textures/yellow.xpm

F 116,212,52
C 135,206,235


11111111111111 111111111111111
10000000001100 000000000000001
10110000011100 000000000010001
10010000000000 000000000010001
10110000011100 000000000010001
10000000001100 000111011110001
11110111111111 011100000010001
11110111111111 011101010010001
11000000110101 011100000010001
10000000000000 001100000010001
10000000000000 001100010000001
11000000110101 000000000000001
11110111110101 000000000000001
10000000001100 000100000010001
10000000000000 000000000001001
10000000001000 010000000001001
10000000001101 000000N00000001
10000000000100 000001010000001
11111111111111 111111111111111
