NO ./textures/blue.xpm
WE ./textures/green.xpm
SO ./textures/red.xpm
EA ./textures/yellow.xpm
F 116,212,52
C 135,206,235

 1111111111111111111111
10000000000S000000000001
 1000000000000000000001
111111111111111111111111
000000000000000000000000