NO ./textures/blue.xpm
WE ./textures/green.xpm
SO ./textures/red.xpm
EA ./textures/yellow.xpm

F 116,212,52
C 135,206,235



  111111111111111111
  1 1100000000000001
 1010011100000011111
 10001   11000001
 10000111000000111111111111111
 100000N0000000000000000000001
 11111111111111111110000000001
                    1000000001
                1   1000000001
                1   1111111111